1111111111111111111111111111
1000000110000000000110000001
1211110110111111110110111121
1011110110111111110110111101
1000000000000000000000000001
1110110111110110111110110111
1110110111110110111110110111
1110110111110110111110110111
5550110000000110000000110555
1110111115111111115111110111
1110111115111111115111110111
1110555555555555555555550111
1110111115111551115111110111
1110111115111551115111110111
1110115555114789115555110111
1110115115111111115115110111
1110115115111111115115110111
5550555115555555555115550555
1110111111115115111111110111
1110111111115115111111110111
1110000000555115550000000111
1110111110111111110111110111
1110111110111111110111110111
1000000000000060000000000001
1011110111110110111110111101
1011110111110110111110111101
1011110110000110000110111101
1011110110111111110110111101
1011110110111111110110111101
1000000000000000000000000001
1111111111111111111111111111