1111111111111111111111111111
1200000000000110000000000021
1011110111110110111110111101
1011110111110110111110111101
1011110111110110111110111101
1000000000000000000000000001
1011110110111111110110111101
1011110110111111110110111101
1000000110000110000110000001
1111110111115115111110111111
1111110111115115111110111111
1111110115555555555110111111
1111110115111551115110111111
1111110115111331115110111111
5555550555114789115550555555
1111110115111111115110111111
1111110115111111115110111111
1111110115555555555110111111
1111110115111111115110111111
1111110115111111115110111111
1000000000000110000000000001
1011110111110110111110111101
1011110111110110111110111101
1000110000000060000000110001
1110110110111111110110110111
1110110110111111110110110111
1000000110000110000110000001
1011111111110110111111111101
1011111111110110111111111101
1200000000000000000000000021
1111111111111111111111111111