1111111111111111111111111111
1000000000110000110000000001
1011111110110110110111111101
1011111110110110110111111101
1011000000000110000000001101
1011011011110110111101101101
1000011011110110111101100001
1111011011110110111101101111
1111011000000000000001101111
0000011110111111110111100000
1011011110111111110111101101
1011000000000000000000001101
1011110110111551110110111101
1011110110111331110110111101
1000000110114789110110000001
1011011110111111110111101101
1011011110111111110111101101
1011000000000000000000001101
1011110111110110111110111101
1011110111110110111110111101
1000000110000110000110000001
1110110110111111110110110111
1110110110111111110110110111
1000110000000060000000110001
1011110111110110111110111101
1011110111110110111110111101
1000000110000110000110000001
1011110110111111110110111101
1011110110111111110110111101
1000000110000000000110000001
1111111111111111111111111111