1111111111111111111111111111
1000000000000000000000000001
1011011110111111110111101101
1011011110111111110111101101
1011011110110000110111101101
1011000000110110110000001101
1011110110110110110110111101
1011110110110110110110111101
1000000110000110000110000001
1110111111110110111111110111
1110111111110110111111110111
1110000110000000000110000111
1110110110111551110110110111
0000110110111331110110110000
1111110000114789110000111111
1111110110111111110110111111
0000110110111111110110110000
1110110110000000000110110111
1110000111110110111110000111
1110110111110110111110110111
1110110000000110000000110111
1110111110110110110111110111
1110111110110110110111110111
1000000000110600110000000001
1011110110111111110110111101
1011110110111111110110111101
1011000110000000000110001101
1011011111110110111111101101
1011011111110110111111101101
1000000000000110000000000001
1111111111111111111111111111